### ###############
#                 #
#                 #
#############  ####
#                 #
##  ###### ########
#        ###      #
####              0
###################