### ###############
#                 #
####### # # # # # #
################# #
######            #
###### ############
#                 0
###################