### ##############
#           #    #
##########  #    #
#           #    #
#  ##########    #
#                0
#          #######
####     #########
##################     